20
15
...++++.............
........+++.........
...........++++++.X.
....+....++++.......
.................&..
..+....++++.........
.......+...++++.....
...............+++++
+++++++.............
++++++++++++........
....................
.............+++++++
++++................
++++++++............
+++++++++++++.....O.
++++++++++++++++....

