12
10
..++++......
......+++...
....X.....+.
++++...&....
++..........
............
.++++++++...
............
.....++++++.
.......O....