12
5
+++++++....O
+...X++..+..
+.&......+..
+....++..+..
+++++++.....